############
#H....#.p.g#
#####.#.##.#
#...#.#.#..#
#.#.#.#.#.W#
#.#...#.#..#
#.#.#......#
#...#.#...p#
#W#.#p#p#..#
############