############
#H....#.p.g#
#####.#.#..#
#...#.#.#..#
#.#.#.#.#..#
#.#...#.#..#
#.#.#......#
#...#.#...p#
#W#.#p#p#..#
############