############
#H.....p...#
#..p..p....#
#....p.....#
#......p..W#
#..p.......#
#.....p....#
#....p.....#
#....g.....#
############