############
#H.....#...#
#.#.#..#pW.#
#.#.#..#...#
#...#..#...#
###.#..###.#
#...#......#
#...#......#
#...#.p#...#
#...#..#g..#
############