############
#H..p....g.#
#..###..#..#
#..#W#..#..#
#..###p.#..#
#..........#
#.........p#
#.....#....#
#.....#....#
############