############
#H...###...#
#...#pW#...#
#...#pg#...#
#...###....#
#........#.#
#..p....#..#
#......p#..#
#......###.#
############